#, ,#,#,#,#,#,#,#,#,#,#,#,#,#,#,#,#,#,#
#, , , , , , , , , , , , , , , , , , ,#
#, ,#,#, ,#,#, ,#,#,#,#,#,#,#,#,#,#, ,#
#, ,#, , , ,#, , , , , , , , , , ,#, ,#
#, ,#, ,#, ,#, ,#,#,#,#,#,#,#,#, ,#, ,#
#, ,#, ,#, ,#, ,#, , , , , , ,#, ,#, ,#
#, ,#, ,#, ,#, ,#, ,#,#,#,#, ,#, ,#, ,#
#, ,#, ,#, ,#, ,#, ,#, ,X,#, ,#, ,#, ,#
#, ,#, ,#, ,#, ,#, ,#, ,#,#, ,#, ,#, ,#
#, ,#, ,#, ,#, ,#, ,#, , , , ,#, ,#, ,#
#, ,#, ,#, ,#, ,#, ,#,#,#,#,#,#, ,#, ,#
#, ,#, ,#, ,#, ,#, , , , , , , , ,#, ,#
#, ,#, ,#, ,#, ,#,#,#,#,#,#,#,#,#,#, ,#
#,O,#, ,#, ,#, , , , , , , , , , , , ,#
